# Configuration
yes="s"
no="n"
yesmatch="s"
nomatch="n"

server="servidor"
agent="cliente"
local="local"
ajuda="ajuda"

# Global
moreinfo="Maiores informa√ß√µes em: "
starting="Iniciando o OSSEC HIDS"
systemis="Systema:"
modifiedinit="Modificado o script de inicializacao para executar o OSSEC HIDS durante o boot."
noboot="Sistema desconhecido. N√£o foi adicionado ao script de Inicializa√ß√£o."

# Part 1
installscript="Script de instala√ß√£o"
system="Sistema"
user="Usu√°rio"
host="Host"
hitanyorabort="Aperte qualquer tecla para continuar ou Ctrl+C para abortar."
whattoinstall="Que tipo de instalacao voce quer? (servidor, cliente, local ou ajuda)?"
serverchose="Instalacao 'Servidor' escolhida."
clientchose="Instalacao 'Cliente' escolhida."
localchose="Instalacao 'Local' escolhida."

# Part 2
settingupenv="Ajustando o ambiente de configura√ß√£o."
wheretoinstall="Escolha onde instalar o OSSEC HIDS"
installat="A instala√ß√£o ser√° feita em "
deletedir="O diret√≥rio e instalacao ja existe. Deseja remove-lo?"

# Part 3
configuring="Configurando"
mailnotify="Deseja receber as notifica√ß√µes por e-mail?"
nomail="Desabilitado a notifica√ß√£o por e-mail"
whatsemail="Qual o seu endere√ßo de e-mail?"
yoursmtp="Seu servidor SMTP foi encontrada como"
usesmtp="Deseja usa-lo?"
usingsmtp="Usando servidor SMTP: "
whatsmtp="Qual o ip/host de seu servidor SMTP?"

# Part 3.1/agent
serverip="Qual o endere√ßo de IP do servidor OSSEC HIDS?"
addingip="Adicionando IP do servidor"


# Part 3.2
runsyscheck="Deseja executar a verifica√ß√£o da integridade do sistema?"
nosyscheck="Syscheck (Sistema de verifica√ß√£o de integride) desabilitado"
yessyscheck="Syscheck (Sistema de verifica√ß√£o de integrida) habilitado"

# Part 3.3
runrootcheck="Gostaria de executar o sistema de detec√ß√ de rootkis?"
norootcheck="Rootcheck (Sistema de detec√ß√ de rootkits) desabilitado"
yesrootcheck="Rootcheck (Sistem de detec√ß√ de rootkits) habilitado"

# Part 3.4/server/local
enable_ar="Gostaria de ter o sistema de resposta ativa de incidentes habilitada?"
noactive="Resposta ativa de incidentes desabilitada"
nohosts="host-deny desabilitado"
yeshosts="host-deny habilitado (local) para niveis >= 6"
firewallar="Gostaria de habilitar a resposta do firewall-drop?"
nofirewall="firewall-drop desabilitado"
yesfirewall="firewall-drop habilitado (local) para niveis >= 6"
defaultwhitelist="Default white list for the active response:"
addwhite="Do you want to add more IPs to the white list?"
ipswhite="IPs (space separated): "
defaultwhitelist="Lista de enderecos IPS que nao serao bloqueados pela resposta automatica:"
addwhite="Voce deseja adicionar mais algum endereco a essa lista?"
ipswhite="Enderecos IP (separados por espaco): "


# Part 3.5/server/local
syslog="Gostaria de habilitar o sistema de log remoto (514 udp)?"
nosyslog="N√£o escutando na porta de syslog"
yessyslog="Escutando mensagens remotas de syslog"

# Part 3.4/3.5
readlogs="Ajustando a configura√ß√£o para anasar os seguintes registros:"

# Part 5
installing="Instalando o sistema"
runningmake="Executando o Makefile"

# Final
configurationdone="Configura√ß√£o terminada corretamente"
tostart="Para come√ßar OSSEC HIDS"
tostop="Para parar OSSEC HIDS"
configat="A configura√ß√£o pode ser vista ou modificado em"
addserveragent="Voc√™ necessita adicionar cada usu√°rio antes que estejam autozados a acessar. "
runma="Execute 'manage_agents' para adicionar ou remover."
presskey="Precione qualquer tecla para continuar."

